1111111111111
100C0000000C1
1000011M11001
1P00111E00001
1111111111111