1111111111111
100C00P0000C1
1000011M11001
1000111E00001
1111111111111